                                                            
                               ┌─┐  ┌─┐                     
                               │E│► │E│                     
                               └─┘  └─┘                     
                                     ▼                      
                                ▲                           
                               ┌─┐  ┌─┐                     
                               │E│  │E│                     
                               └─┘  └─┘                     
                                     ▼                      
                                ▲                           
                          ┌─┐  ┌─┐  ┌─┐                     
                          │E│  │E│  │E│                     
                          └─┘  └─┘  └─┘                     
                           ▼         ▼                      
                           ▲    ▲    ▲                      
                     ┌─┐  ┌─┐  ┌─┐  ┌─┐  ┌─┐  ┌─┐           
                     │E│ ◄│E│►◄│E│►◄│E│► │E│► │E│           
                     └─┘  └─┘  └─┘  └─┘  └─┘  └─┘           
                      ▼              ▼         ▼            
                                ▲    ▲                      
      ┌─┐  ┌─┐       ┌─┐  ┌─┐  ┌─┐  ┌─┐       ┌─┐           
      │E│ ◄│E│       │E│► │E│►◄│⌂│ ◄│E│       │E│           
      └─┘  └─┘       └─┘  └─┘  └─┘  └─┘       └─┘           
       ▼              ▼    ▼    ▼              ▼            
       ▲    ▲         ▲    ▲         ▲         ▲            
 ┌─┐  ┌─┐  ┌─┐  ┌─┐  ┌─┐  ┌─┐  ┌─┐  ┌─┐  ┌─┐  ┌─┐  ┌─┐      
 │E│►◄│E│ ◄│E│ ◄│E│ ◄│E│ ◄│E│  │E│► │E│► │E│►◄│E│►◄│E│      
 └─┘  └─┘  └─┘  └─┘  └─┘  └─┘  └─┘  └─┘  └─┘  └─┘  └─┘      
       ▼              ▼                   ▼    ▼            
            ▲         ▲    ▲         ▲                      
 ┌─┐  ┌─┐  ┌─┐  ┌─┐  ┌─┐  ┌─┐  ┌─┐  ┌─┐  ┌─┐  ┌─┐  ┌─┐  ┌─┐ 
 │E│►◄│E│► │E│► │E│►◄│E│  │E│► │E│► │E│ ◄│E│ ◄│E│►◄│E│  │G│ 
 └─┘  └─┘  └─┘  └─┘  └─┘  └─┘  └─┘  └─┘  └─┘  └─┘  └─┘  └─┘ 
                      ▼              ▼    ▼                 
                           ▲                             ▲  
                     ┌─┐  ┌─┐  ┌─┐  ┌─┐  ┌─┐  ┌─┐  ┌─┐  ┌─┐ 
                     │E│► │E│ ◄│E│ ◄│E│  │E│► │E│► │E│► │E│ 
                     └─┘  └─┘  └─┘  └─┘  └─┘  └─┘  └─┘  └─┘ 
                                                    ▼       
                                                    ▲       
                                                   ┌─┐      
                                                   │E│      
                                                   └─┘      
                                                            
