                                                                 
 ┌─┐  ┌─┐                                                        
 │g│ ◄│e│                                                        
 └─┘  └─┘                                                        
                                                                 
       ▲                                                         
      ┌─┐  ┌─┐            ┌─┐                                    
      │e│ ◄│e│            │e│                                    
      └─┘  └─┘            └─┘                                    
                           ▼                                     
            ▲              ▲                                     
      ┌─┐  ┌─┐  ┌─┐  ┌─┐  ┌─┐  ┌─┐                               
      │e│►◄│e│ ◄│e│ ◄│e│  │e│►◄│e│                               
      └─┘  └─┘  └─┘  └─┘  └─┘  └─┘                               
                           ▼                                     
                      ▲    ▲                                     
                     ┌─┐  ┌─┐  ┌─┐       ┌─┐                     
                     │e│  │e│►◄│e│       │e│                     
                     └─┘  └─┘  └─┘       └─┘                     
                           ▼              ▼                      
                      ▲    ▲              ▲                      
                     ┌─┐  ┌─┐  ┌─┐       ┌─┐            ┌─┐  ┌─┐ 
                     │e│  │e│ ◄│e│       │e│            │e│  │e│ 
                     └─┘  └─┘  └─┘       └─┘            └─┘  └─┘ 
                           ▼              ▼              ▼    ▼  
                      ▲         ▲         ▲              ▲    ▲  
                     ┌─┐  ┌─┐  ┌─┐  ┌─┐  ┌─┐       ┌─┐  ┌─┐  ┌─┐ 
                     │e│ ◄│e│  │e│►◄│e│►◄│e│       │e│►◄│e│►◄│e│ 
                     └─┘  └─┘  └─┘  └─┘  └─┘       └─┘  └─┘  └─┘ 
                           ▼              ▼         ▼    ▼       
                           ▲    ▲         ▲         ▲         ▲  
                          ┌─┐  ┌─┐       ┌─┐  ┌─┐  ┌─┐  ┌─┐  ┌─┐ 
                          │e│  │e│       │e│►◄│e│►◄│e│►◄│e│► │e│ 
                          └─┘  └─┘       └─┘  └─┘  └─┘  └─┘  └─┘ 
                                               ▼                 
                                ▲         ▲    ▲                 
                          ┌─┐  ┌─┐  ┌─┐  ┌─┐  ┌─┐                
                          │e│►◄│e│►◄│e│  │e│►◄│e│                
                          └─┘  └─┘  └─┘  └─┘  └─┘                
                                          ▼                      
                                ▲         ▲                      
                               ┌─┐       ┌─┐                     
                               │e│       │e│                     
                               └─┘       └─┘                     
                                                                 
                                ▲                                
                               ┌─┐  ┌─┐  ┌─┐                     
                               │e│  │e│ ◄│e│                     
                               └─┘  └─┘  └─┘                     
                                     ▼                           
                                ▲         ▲                      
                               ┌─┐  ┌─┐  ┌─┐  ┌─┐                
                               │e│►◄│e│  │e│ ◄│s│                
                               └─┘  └─┘  └─┘  └─┘                
                                     ▼                           
                                ▲                                
                               ┌─┐  ┌─┐                          
                               │e│ ◄│e│                          
                               └─┘  └─┘                          
                                                                 
