                                                       
           ┌─┐  ┌─┐                                    
           │e│► │e│                                    
           └─┘  └─┘                                    
                 ▼                                     
            ▲    ▲                                     
           ┌─┐  ┌─┐  ┌─┐       ┌─┐                     
           │e│ ◄│e│►◄│e│       │e│                     
           └─┘  └─┘  └─┘       └─┘                     
            ▼    ▼              ▼                      
            ▲    ▲              ▲                      
      ┌─┐  ┌─┐  ┌─┐       ┌─┐  ┌─┐  ┌─┐  ┌─┐           
      │e│►◄│e│  │e│       │e│►◄│e│ ◄│e│ ◄│e│           
      └─┘  └─┘  └─┘       └─┘  └─┘  └─┘  └─┘           
       ▼    ▼              ▼    ▼                      
            ▲    ▲         ▲    ▲         ▲            
      ┌─┐  ┌─┐  ┌─┐  ┌─┐  ┌─┐  ┌─┐  ┌─┐  ┌─┐  ┌─┐      
      │e│►◄│e│►◄│e│ ◄│e│ ◄│s│  │e│► │e│► │e│►◄│e│      
      └─┘  └─┘  └─┘  └─┘  └─┘  └─┘  └─┘  └─┘  └─┘      
       ▼                   ▼    ▼                      
                           ▲    ▲                      
 ┌─┐  ┌─┐       ┌─┐  ┌─┐  ┌─┐  ┌─┐            ┌─┐  ┌─┐ 
 │e│►◄│e│       │e│ ◄│e│ ◄│e│ ◄│e│            │e│► │g│ 
 └─┘  └─┘       └─┘  └─┘  └─┘  └─┘            └─┘  └─┘ 
       ▼         ▼                                     
                                ▲              ▲       
      ┌─┐       ┌─┐  ┌─┐  ┌─┐  ┌─┐  ┌─┐  ┌─┐  ┌─┐      
      │e│       │e│► │e│► │e│► │e│  │e│  │e│► │e│      
      └─┘       └─┘  └─┘  └─┘  └─┘  └─┘  └─┘  └─┘      
       ▼                             ▼                 
       ▲                             ▲    ▲            
      ┌─┐  ┌─┐  ┌─┐  ┌─┐  ┌─┐  ┌─┐  ┌─┐  ┌─┐           
      │e│  │e│► │e│► │e│► │e│► │e│  │e│► │e│           
      └─┘  └─┘  └─┘  └─┘  └─┘  └─┘  └─┘  └─┘           
       ▼                   ▼    ▼                      
            ▲              ▲         ▲                 
 ┌─┐  ┌─┐  ┌─┐            ┌─┐  ┌─┐  ┌─┐                
 │e│►◄│e│► │e│            │e│  │e│► │e│                
 └─┘  └─┘  └─┘            └─┘  └─┘  └─┘                
                                                       
